County,Population,Trump,Clinton,Johnson,Others,Total
Adair,7010,2461,1133,127,90,3811
Adams,3716,1395,565,93,53,2106
Allamakee,13869,4093,2421,227,182,6923
Appanoose,12497,4033,1814,139,150,6136
Audubon,5635,2136,1080,107,89,3412
Benton,25641,8232,4678,542,392,13844
Black Hawk,132813,27476,32233,2368,2328,64405
Boone,26419,7484,5541,643,528,14196
Bremer,24784,7208,5356,543,431,13538
Buchanan,21034,5510,3970,478,294,10252
Buena Vista,20268,4903,2856,288,231,8278
Butler,14687,4921,2157,219,216,7513
Calhoun,9799,3468,1398,173,120,5159
Carroll,20366,6638,3309,318,279,10544
Cass,13180,4761,1951,206,207,7125
Cedar,18407,5295,3599,365,282,9541
Cerro Gordo,43064,11621,9862,851,631,22965
Cherokee,11404,4192,1679,206,181,6258
Chickasaw,12063,3742,2266,236,191,6435
Clarke,9286,2713,1465,160,116,4454
Clay,16325,5877,2249,288,203,8617
Clayton,17647,5317,3237,334,241,9129
Clinton,47236,11276,10095,825,871,23067
Crawford,17036,4617,1991,172,155,6935
Dallas,84185,19339,15701,1757,1455,38252
Davis,8901,2723,977,85,97,3882
Decatur,8045,2296,1201,123,114,3734
Delaware,17269,5694,2957,337,253,9241
Des Moines,39625,9529,8212,635,727,19103
Dickinson,17104,6753,3056,292,253,10354
Dubuque,96704,23460,22850,2013,1398,49721
Emmet,9558,3124,1357,139,133,4753
Fayette,19986,5620,3689,328,338,9975
Floyd,15835,4375,3179,241,265,8060
Franklin,10200,3163,1493,188,124,4968
Fremont,6960,2407,963,115,110,3595
Greene,9009,2820,1691,160,150,4821
Grundy,12297,4527,1856,233,256,6872
Guthrie,10650,3628,1732,258,132,5750
Hamilton,15100,4463,2726,259,246,7694
Hancock,10893,3977,1587,166,141,5871
Hardin,17193,5254,2787,298,194,8533
Harrison,14072,4902,2131,210,222,7465
Henry,19801,5779,2904,337,384,9404
Howard,9272,2611,1677,131,140,4559
Humboldt,9531,3568,1252,127,140,5087
Ida,6957,2655,792,103,62,3612
Iowa,16184,5205,3084,317,298,8904
Jackson,19390,5824,3837,319,330,10310
Jasper,36661,11560,6109,715,650,19034
Jefferson,18172,3748,3710,246,452,8156
Johnson,146633,21044,50200,2758,2938,76940
Jones,20384,5720,3787,305,321,10133
Keokuk,10177,3390,1342,139,114,4985
Kossuth,15133,5653,2543,194,217,8607
Lee,34456,8803,6215,510,623,16151
Linn,221900,48390,58935,5557,4216,117098
Louisa,11188,3069,1648,136,155,5008
Lucas,8556,2877,1239,115,123,4354
Lyon,11788,5192,920,137,128,6377
Madison,15794,5360,2678,347,251,8636
Mahaska,22206,7432,2619,318,263,10632
Marion,33149,10962,5482,706,666,17816
Marshall,40160,9146,7652,577,605,17980
Mills,15044,5867,1996,307,234,7698
Mitchell,10657,3190,1888,210,129,5417
Monona,8799,3120,1247,112,93,4572
Monroe,7853,2638,1056,104,67,3865
Montgomery,10134,3436,1314,152,142,5044
Muscatine,42904,9584,8368,748,734,19434
O'Brien,13921,5752,1315,197,142,7406
Osceola,6084,2531,552,73,57,3213
Page,15335,4893,1807,176,168,7044
Palo Alto,9042,3081,1398,131,93,4703
Plymouth,25205,9680,2885,343,282,13190
Pocahontas,6848,2702,963,115,85,3865
Polk,474768,93492,119804,10029,8230,231555
Pottawattamie,93508,24447,15355,1469,1409,42680
Poweshiek,18292,4946,4304,283,300,9833
Ringgold,4989,1824,753,72,58,2707
Sac,9818,3703,1270,129,110,5212
Scott,172045,39149,40440,3555,3076,86220
Shelby,11672,4362,1662,174,172,6370
Sioux,34891,14785,2300,435,674,18194
Story,96816,19458,25709,3014,2486,50667
Tama,17179,4971,3196,245,340,8752
Taylor,6237,2111,758,97,63,3029
Union,12390,3525,1922,213,172,5832
Van Buren,7255,2527,845,83,106,3561
Wapello,35270,8715,5594,380,460,15149
Warren,49343,14814,10411,1275,800,27300
Washington,22109,6173,3943,459,354,10929
Wayne,6437,2069,719,78,74,2940
Webster,36752,10056,6305,569,500,17430
Winnebago,10601,3447,1931,218,191,5787
Winneshiek,20409,5344,5254,382,382,11362
Woodbury,102707,24727,16210,1179,1602,43718
Worth,7475,2453,1530,165,109,4257
Wright,12816,3800,1896,176,154,6026
,,,,,,